15
15
PPPPPPPPPPPPPPP
PPPPPPPPPPPPPPP
PPPPPPPPPPPPPPP
PPPCCCCCCCCCPPP
PPPCCCCCCCCCPPP
PPPCCCCCCCCCPPP
PPPCCCCCCCCCPPP
PPPCCCCMCCCCPPP
PPPCCCCCCCCCPPP
PPPCCCCCCCCCPPP
PPPCCCCCCCCCPPP
PPPCCCCCCCCCPPP
PPPPPPPPPPPPPPP
PPPPPPPPPPPPPPP
PPPPPPPPPPPPPPP
000000000000000
000000000000000
000000000000000
000000000000000
000000000000000
000000000000000
000000000000000
000000000000000
000000000000000
000000000000000
000000000000000
000000000000000
000000000000000
000000000000000
000000000000000
